....................
....................
....................
....................
....................
....................
....................
..F......GFG........
.~~......###........
....................
....GFG.......GGG...
....###.......###...
....................
.1................X.
####################
