....................
....................
....................
.......######.......
X.G..............G..
####..G.G.G.G....###
.......F.G.GCG......
......--------......
...--...........--..
......GFB..GGGG.....
.G.G..###.......GFC.
####..GGG..GGFG.####
......GGG..GGGG.....
....GGG..1..........
####################
