....................
...FX...............
...--..D.......--...
....G.--........G...
...--..........--...
...G......G....G....
...--....--....--...
....G..GAF.....CG...
...--..~~~...G.--...
...G........--.G....
...--..........--...
...FG...........G...
...--..........--...
.........1..........
####################
