....................
.........FF.........
.......------...X...
...--..........--...
..G..............G..
####..G.F.G.G....###
.......G.G.GBG......
......--------......
...--...........--..
....................
AG.F.D..............
##########..........
....................
.1..GGGGGGGG..GFGCGG
#############.######
