....................
....................
...XF..------.......
...--..........--...
..F..............G..
####..G.G.G.G....###
.......GCG.FBG......
...F..--------......
...--...........--..
................F...
AG.G.D..............
######---#......~~..
....................
.FGCGAGBGGF...GGG.1.
#############.######