....................
....................
....X.......F.......
...###.....---......
..G.....AFFB....##..
.--.....----........
.....G...G...G...F..
...G...F...G...G....
...........~...-....
GGAFBGC.....GG...--.
##########..........
.............~~~....
G..G..G..G..G..G..G.
.........1..........
#####..#####..######